

R 1920 1080
NO    ./textures/north_wall.XPM

SO ./textures/bookshelf.xpm
WE ./textures/west_wall.XPM

EA ./textures/east_wall.XPM
S ./textures/skeleton.xpm
F 220,100,0

C 225,30,0


11111111111111111111111111111
10000000001100000000000000001
10110000011100000020000010001
10010020000000000000000010001
10110000011100000000000010N01
10000000001100000111011110001
11110111111111001100000010001
11110111111111011101010010001
11000000110101011100000010001
10002000000000001100000010001
10000000000000001101010010001
11000000110101011111011110001
11110111111101011111011110001
11111111111111111111111111111