R 700 1080
NO    ./textures/north_wall.XPM
C 252,30,0
SO ./textures/bookshelf.xpm
WE ./textures/west_wall.XPM


EA ./textures/east_wall.XPM
S ./textures/skeleton.xpm
F 0,100,0

111111
100201
100S01111
1 00011
11110111
10 0000111
111101011111111
122001111000001
100011111220001
110222000111101111
110000001000000000111
1111111000011112200001
11111111111111111111111111