                   R                 34343 777777
NO ./textures/barrel.xpm

    SO    ./textures/table-chairs.xpm
        EA  ./textures/east_wall.XPM
    WE ./textures/west_wall.XPM


    S               ./textures/lamp.xpm
    C 138,43,226
    F                176,196,222

11111111111111
10200000000001
10000000000001111111111
11111002000200000020001
    1000000000011111111
    100200020001
    100000000001     111111
    10000000000111111102001  111    111    1   1   1  1
    11111111000000000000001  1  1   1  1   1   1   1  1
           100000000000000111111    1111   1   1   1111
           100000N000002001  1  1   1  1   1   1   1  1
  1111111111000000000000001  11111111  1111111111111  1
  1000000000000000000000001
  1000000000000000000000001
  10200201111111111111100011
  10000001            100001
  1020020111111111    100001
  10000000000000011111111101
  11111111111111000000000001
               1111111001111
                     1001
            11111    1001
            1000111111001
            1020000000001
            1000111111111
            11111